MH___S______T
__L__B____M_T
BTTTTTBBL___T
_____T____L_T
_|__MB____TTT
_M___T__-___M
TTTTTT__M____
TM_________L_
TTT_SLSS_____
_____________
SV__S__M__L__
>___S_+<_S_T_
