_V__SBS__S__M__
____SSS_KSSSSSS
-___MM__LS_____
_TBT_____S_____
_TTT__T___B__>_
_LMMMM___S__n__
_TBT_____S_____
