q_____S____M
SSS_S_S__|__
B___S_S_M___
____SHS___W_
_B__SSSSSSSS
____P__K__T_
_TBT________
_TTT__+-__T_
____________
BSSSSBBSSSBB
__n____M____
___<___>_S__
