S_____________S
_______________
_______________
_______________
_______________
V_________M__N_
S_____________S
